track_name,artist(s)_name,artist_count,released_year,16-Aug,17-Aug,18-Aug,19-Aug,20-Aug,21-Aug,22-Aug,final,,in_spotify_playlists,in_spotify_charts,in_apple_playlists,in_apple_charts,in_deezer_playlists,in_deezer_charts,genre,in_shazam_charts,,,,,Day1,Day2,Day3,Day4,Day5,Day6
Takci,Kalush,1,2021,5276788,5279441,5282249,5284918,5287204,5289652,5292048,5312460,,42,6,3,2,1,0,Pop,0,,1.00045296,1.000463005,1.000432552,2653,2808,2669,2286,2448,2396
My heaven,BigBang,1,2021,10088599,10092433,10096418,10100023,10103539,10107972,10112628,10157987,,34,5,5,1,2,1,Pop,0,,1.000460627,1.000438757,1.000348118,3834,3985,3605,3516,4433,4656
Jhoome Jo Pathaan,"Arijit Singh, Vishal Dadlani, Sukriti Kakar, Vishal-Shekhar, Shekhar Ravjiani, Kumaar",6,2022,205397682,205477887,205545473,205625603,205706435,205779447,205848800,206559695,,138,4,13,78,2,0,Indian Pop,0,,1.000337026,1.000354933,1.000393103,80205,67586,80130,80832,73012,69353
Overdrive,Post Malone,1,2023,140220860,140403218,140622259,140799207,140941544,141128637,141271933,140959180,,410,36,36,32,31,1,Pop,26,,1.001015357,1.001327451,1.001010922,182358,219041,176948,142337,187093,143296
S91,Karol G,1,2023,256078189,256334849,256553766,256791633,256988002,257204124,257423081,257699418,,525,41,34,115,39,6,Spanish Hip-Hop,216,,1.000851297,1.000840981,1.000764702,256660,218917,237867,196369,216122,218957
Better Than Revenge (Taylor's Version),Taylor Swift,1,2023,133895283,134027317,134172172,134306778,134433569,134571641,134710271,134847970,,86,11,3,33,3,0,Pop,1,,1.001030158,1.001027065,1.00094404,132034,144855,134606,126791,138072,138630
Phantom Regret by Jim,The Weeknd,1,2022,37164411,37175578,37187345,37197907,37207828,37219232,37242524,37417774,,768,0,1,1,3,0,Rock,0,,1.000625805,1.000306495,1.000266709,11167,11767,10562,9921,11404,11646
Mother I Sober (feat. Beth Gibbons of Portishead),"Kendrick Lamar, Beth Gibbons",2,2022,43436948,43461064,43489539,43515564,43540181,43568114,43624396,43587793,,1890,0,3,0,2,0,Hip-Hop,0,,1.001291816,1.000641545,1.000565706,24116,28475,26025,24617,27933,28141
Mine (Taylor's Version),Taylor Swift,1,2023,188197194,188408366,188636556,188845187,189046827,189260698,189479720,189199438,,99,15,21,52,6,1,Romantic,0,,1.00115725,1.001131312,1.001067753,211172,228190,208631,201640,213871,219022
Savior - Interlude,Kendrick Lamar,1,2022,46966781,46989102,47015802,47037670,47058530,47081889,47129537,47137451,,1194,0,0,0,3,0,Rock,0,,1.001012024,1.000496382,1.000443474,22321,26700,21868,20860,23359,23824
Every Angel is Terrifying,The Weeknd,1,2022,42815495,42827995,42840810,42852384,42863304,42876038,42902039,43130490,,715,0,0,1,2,0,Rock,0,,1.000606423,1.000297084,1.000254828,12500,12815,11574,10920,12734,13001
Auntie Diaries,Kendrick Lamar,1,2022,47270385,47291612,47316848,47337279,47357236,47379574,47425820,47572529,,1545,0,1,0,4,0,Hip-Hop,0,,1.000976075,1.000471691,1.000421592,21227,25236,20431,19957,22338,23123
Back To December (Taylor's Version),Taylor Swift,1,2023,205786044,205998568,206195654,206389856,206580835,206784781,206993445,206956080,,139,17,16,72,5,0,Romantic,8,,1.001009088,1.000987246,1.000925331,212524,197086,194202,190979,203946,208664
Enchanted (Taylor's Version),Taylor Swift,1,2023,316778540,317260752,317717148,318168827,318605810,319073451,319543965,318577959,,148,24,32,93,8,2,Romantic,5,,1.001474626,1.001467773,1.001373431,482212,456396,451679,436983,467641,470514
Rich - Interlude,Kendrick Lamar,1,2022,50417246,50438265,50460323,50480073,50498786,50520004,50561824,50700562,,1103,0,0,0,0,0,Hip-Hop,0,,1.000827791,1.000420169,1.000370701,21019,22058,19750,18713,21218,20910
A Tale By Quincy,The Weeknd,1,2022,48034722,48047609,48061851,48074063,48085647,48099024,48126652,48460518,,733,0,0,2,2,0,Rock,0,,1.000574398,1.000278191,1.000240962,12887,14242,12212,11584,13377,13814
Crown,Kendrick Lamar,1,2022,53961172,53988934,54018097,54043641,54068378,54096327,54154254,54274109,,1493,0,2,0,10,0,Pop,0,,1.001070812,1.00051692,1.000457723,27762,29163,25544,24737,27949,28963
Mirror,Kendrick Lamar,1,2022,73896738,73951718,73999318,74045857,74089461,74141534,74246706,74470729,,1929,0,2,0,4,0,Pop,0,,1.00141853,1.00070284,1.000588878,54980,47600,46539,43604,52073,52586
Stefania (Kalush Orchestra),KALUSH,1,2022,64751547,64771131,64789648,64808205,64825786,64844920,64863620,65265572,,555,0,10,4,4,0,Pop,0,,1.00028838,1.00029516,1.000271277,19584,18517,18557,17581,19134,18700
Still Life,BIGBANG,1,2022,66427048,66452288,66478607,66501817,66524933,66551280,66578109,66862300,,181,0,16,14,7,0,Pop,0,,1.000403133,1.000396047,1.0003476,25240,26319,23210,23116,26347,26829
Dawn FM,The Weeknd,1,2022,62994564,63011872,63030237,63046845,63062569,63082090,63119692,63350638,,811,0,1,8,6,0,Pop,0,,1.00059608,1.00030955,1.000249402,17308,18365,16608,15724,19521,18801
AMERICA HAS A PROBLEM (feat. Kendrick Lamar),"Kendrick Lamar, Beyonce",2,2023,110370626,110433463,110492222,110551163,110604860,110664665,110785628,110866814,,896,0,34,2,33,0,Hip-Hop,1,,1.001093059,1.000540709,1.000485721,62837,58759,58941,53697,59805,60841
Mr. Morale,"Kendrick Lamar, Tanna Leone",2,2022,77730686,77782101,77827770,77871409,77911894,77958931,78055202,78379395,,1860,0,1,0,3,0,Rock,0,,1.001234894,1.00060372,1.000519896,51415,45669,43639,40485,47037,48135
MOJABI GHOST,"Tainy, Bad Bunny",2,2023,412758396,413457197,414135738,414802995,415362992,415963734,417260665,415864445,,859,40,35,109,41,14,Spanish Rock,211,,1.003117894,1.001446306,1.001350031,698801,678541,667257,559997,600742,648465
Worldwide Steppers,Kendrick Lamar,1,2022,76738353,76774621,76807650,76839325,76869195,76903394,76973036,77063864,,1480,0,1,0,5,0,Hip-Hop,0,,1.000905578,1.000444899,1.000388733,36268,33029,31675,29870,34199,34821
"Phir Aur Kya Chahiye (From ""Zara Hatke Zara Bachke"")","Arijit Singh, Sachin-Jigar, Amitabha Bhattacharya",3,2023,241224487,241398766,241583884,241778368,241972575,242148731,242346325,242094298,,178,6,6,71,1,0,Indian Romantic,31,,1.000816003,1.000728,1.000803244,174279,185118,194484,194207,176156,197594
Hits Different,Taylor Swift,1,2023,198715664,198905051,199073809,199237552,199397840,199578623,199767586,200323840,,547,0,15,15,6,0,Pop,0,,1.00094681,1.000906645,1.000804507,189387,168758,163743,160288,180783,188963
We Cry Together,"Kendrick Lamar, Taylour Paige",2,2022,89912931,89961502,90007009,90049963,90090702,90136770,90231536,90462221,,1635,0,4,1,6,0,Hip-Hop,0,,1.001051358,1.000511351,1.000452404,48571,45507,42954,40739,46068,47383
The Heart Part 5,Kendrick Lamar,1,2022,93603876,93653704,93711573,93761386,93807955,93861446,93970911,94324998,,2939,0,29,0,30,0,Hip-Hop,0,,1.00116624,1.000570218,1.000496676,49828,57869,49813,46569,53491,54732
Starry Eyes,The Weeknd,1,2022,95377276,95422776,95465196,95505701,95542922,95586293,95674540,96111413,,1014,0,1,17,11,0,Pop,0,,1.000923218,1.000453943,1.000389725,45500,42420,40505,37221,43371,44123
Purple Hearts,"Kendrick Lamar, Ghostface Killah, Summer Walker",3,2022,98695414,98743555,98800238,98848351,98893091,98944059,99049284,98983049,,2308,0,7,0,7,0,Romantic,0,,1.00106348,1.000515385,1.000452613,48141,56683,48113,44740,50968,52612
Savior,"Kendrick Lamar, Sam Dew, Baby Keem",3,2022,112662422,112727648,112790230,112848019,112902341,112965020,113095019,113506728,,2291,0,9,0,8,0,Rock,0,,1.00115079,1.000555161,1.000481373,65226,62582,57789,54322,62679,64998
I Heard You're Married (feat. Lil Wayne),"The Weeknd, Lil Wayne",2,2022,105491121,105522586,105548872,105575419,105600474,105629730,105690712,106355591,,1178,0,9,10,9,0,Pop,0,,1.000577319,1.000277044,1.000237318,31465,26286,26547,25055,29256,30491
Double Fantasy (with Future),"The Weeknd, Future",2,2023,189689163,189828533,189963008,190092161,190211971,190344457,190480070,190710632,,1169,0,36,65,28,0,Pop,0,,1.000712461,1.000696518,1.000630273,139370,134475,129153,119810,132486,135613
Best Friends,The Weeknd,1,2022,125524161,125577882,125623096,125669395,125711561,125761466,125859267,126374277,,1292,0,3,18,14,0,Hip-Hop,0,,1.000777671,1.00039698,1.000335531,53721,45214,46299,42166,49905,48900
Popular (with Playboi Carti & Madonna) - The Idol Vol. 1 (Music from the HBO Original Series),"The Weeknd, Madonna, Playboi Carti",3,2023,888044206,889124915,890294453,891390871,892421628,893502469,894580880,892843886,,1945,87,74,182,87,14,Pop,"1,093",,1.001206948,1.001211133,1.001156347,1080709,1169538,1096418,1030757,1080841,1078411
How Do I Make You Love Me?,The Weeknd,1,2022,151876280,151932917,151998336,152055184,152106406,152166581,152292167,152882792,,1915,0,7,47,15,0,Rock,0,,1.000825319,1.000395611,1.000336865,56637,65419,56848,51222,60175,62793
Bigger Than The Whole Sky,Taylor Swift,1,2022,190503121,190615903,190747601,190857684,190967429,191091789,191217484,191214197,,1180,0,4,0,8,0,Pop,0,,1.000657773,1.000651211,1.00057501,112782,131698,110083,109745,124360,125695
Silent Hill,"Kendrick Lamar, Kodak Black",2,2022,157515911,157616650,157713765,157802918,157881414,157969502,158155519,158645547,,3028,0,22,0,23,0,Rock,0,,1.00117755,1.000557938,1.000497431,100739,97115,89153,78496,88088,93808
Count Me Out,Kendrick Lamar,1,2022,220654169,220998790,221298977,221590526,221852033,222148826,222770672,221069881,,2729,0,3,7,13,0,Hip-Hop,1,,1.002799232,1.001337797,1.001180136,344621,300187,291549,261507,296793,310923
Father Time (feat. Sampha),"Kendrick Lamar, Sampha",2,2022,180977054,181111028,181246798,181367659,181478641,181607162,181871976,182203715,,3107,0,4,0,22,0,Rock,0,,1.001458169,1.000708188,1.000611917,133974,135770,120861,110982,128521,132407
"Apna Bana Le (From ""Bhediya"")","Arijit Singh, Sachin-Jigar",2,2022,279650045,280037187,280447488,280885818,281322768,281720168,282123563,280795281,,86,0,11,101,0,0,Indian Romantic ,48,,1.0014319,1.001412612,1.001555614,387142,410301,438330,436950,397400,403395
The Joker And The Queen (feat. Taylor Swift),"Ed Sheeran, Taylor Swift",2,2022,187713899,187796926,187877449,187954588,188028594,188105513,188185220,188694704,,1430,0,46,1,34,0,Romantic,0,,1.000423736,1.000409081,1.000393744,83027,80523,77139,74006,76919,79707
Tormenta (feat. Bad Bunny),"Gorillaz, Bad Bunny",2,2023,202869431,202958767,203050496,203138723,203215687,203300222,203478986,204519547,,1529,0,32,18,39,2,Spanish Hip-Hop,0,,1.00087931,1.000415987,1.000378874,89336,91729,88227,76964,84535,89382
AMARGURA,Karol G,1,2023,725402208,726904839,728530394,730112112,731480759,732977729,734571873,729201921,,1133,39,14,71,23,10,Spanish Hip-Hop,176,,1.002174887,1.002046493,1.001874571,1502631,1625555,1581718,1368647,1496970,1594144
Satranga,Arijit Singh,1,2023,252660065,253155628,253648686,254176452,254711424,255209620,255708157,253672040,,2020,0,77,10,119,0,Indian Romantic,40,,1.001953441,1.001955923,1.002104727,495563,493058,527766,534972,498196,498537
United In Grief,Kendrick Lamar,1,2022,261703864,261949698,262152246,262362641,262562749,262787424,263244372,263412109,,2575,0,4,5,12,0,Hip-Hop,51,,1.00173885,1.0008557,1.000762715,245834,202548,210395,200108,224675,228474
Chemical,Post Malone,1,2023,537669871,538249447,538763474,539311625,539798070,540321581,540854164,540928035,,2528,39,56,91,59,3,Pop,486,,1.000985678,1.000969827,1.000901974,579576,514027,548151,486445,523511,532583
Rich Spirit,Kendrick Lamar,1,2022,271846179,272137648,272446022,272721584,272958079,273225587,273783915,273411340,,3486,0,20,10,33,0,Hip-Hop,0,,1.002043469,1.000980033,1.000867166,291469,308374,275562,236495,267508,279164
"Would've, Could've, Should've",Taylor Swift,1,2022,278887199,279076399,279261085,279431337,279599058,279784531,279971351,280556059,,1715,0,4,5,8,0,Romantic,0,,1.000667728,1.000663353,1.000600223,189200,184686,170252,167721,185473,186820
The Great War,Taylor Swift,1,2022,290811496,290997521,291184211,291353044,291518572,291705153,291893265,292955180,,1274,0,1,6,11,0,Romantic,0,,1.00064487,1.000640031,1.000568135,186025,186690,168833,165528,186581,188112
All Of The Girls You Loved Before,Taylor Swift,1,2019,377640428,377896266,378180207,378433867,378682580,378945014,379213995,380937385,,1282,6,26,6,19,0,Romantic,5,,1.000709815,1.000693018,1.000657217,255838,283941,253660,248713,262434,268981
Sweet Nothing,Taylor Swift,1,2022,285730728,285891301,286071846,286228697,286384305,286558175,286732837,287365977,,1747,0,9,6,13,0,Romantic,2,,1.000609517,1.000607121,1.000543649,160573,180545,156851,155608,173870,174662
Labyrinth,Taylor Swift,1,2022,287132616,287344287,287530332,287714422,287899933,288104166,288309824,282121951,,1597,0,6,3,15,0,Romantic,0,,1.000713832,1.000709389,1.000644775,211671,186045,184090,185511,204233,205658
Less Than Zero,The Weeknd,1,2022,300268375,300459606,300641445,300815482,300977534,301164084,301553045,301678558,,2800,0,18,77,61,0,Romantic,1,,1.001291525,1.000619814,1.000538709,191231,181839,174037,162052,186550,194480
MIENTRAS ME CURO DEL CORA,Karol G,1,2023,470700201,471458147,472280659,473060473,473691053,474362052,475045363,473793389,,1020,35,15,26,30,6,Spanish Hip-Hop,0,,1.001440484,1.001416533,1.00133298,757946,822512,779814,630580,670999,683311
Mastermind,Taylor Swift,1,2022,359481212,359733615,359998774,360237646,360460372,360715154,360970683,362097975,,1936,0,7,5,13,0,Romantic,0,,1.000708396,1.000706824,1.000618275,252403,265159,238872,222726,254782,255529
Chaleya,Arijit Singh,1,2022,366538758,366963828,367464938,367961382,368467154,368930954,369394857,368690671,,2402,0,45,2,26,0,Indian Romantic,1,,1.001257425,1.001258728,1.001374525,425070,501110,496444,505772,463800,463903
Question...?,Taylor Swift,1,2022,305363129,305505055,305621772,305741017,305855860,305985983,306119195,307429987,,1608,0,10,3,12,0,Romantic,0,,1.000435353,1.000425439,1.000375622,141926,116717,119245,114843,130123,133212
Shayad,Arijit Singh,2,2023,378414072,378699728,379009799,379303276,379602933,379875318,380148970,38217201,,894,9,14,88,66,3,Indian Romantic,72,,1.000720373,1.000717552,1.00079002,285656,310071,293477,299657,272385,273652
Die Hard,"Kendrick Lamar, Blxst, Amanda Reifer",3,2022,333353595,333585322,333806590,334017045,334204774,334418396,334857356,336000795,,4627,0,38,13,32,0,Hip-Hop,0,,1.001312607,1.000639195,1.000562034,231727,221268,210455,187729,213622,219480
Heeriye,Arijit Singh,1,2021,326214338,326616112,327020965,327452356,327877400,328285656,328692765,328609265,,2979,0,44,0,159,0,Hip-Hop,0,,1.001240106,1.001245148,1.001298033,401774,404853,431391,425044,408256,407109
Agosto,Bad Bunny,1,2022,327469753,327915089,328417295,328936761,329368010,329860480,330900846,329760162,,897,0,6,20,8,0,Spanish Hip-Hop,0,,1.003153958,1.001495197,1.001311039,445336,502206,519466,431249,492470,520183
Coco Chanel,"Bad Bunny, Eladio Carrion",2,2023,478973209,479276849,479564391,479855498,480107168,480382106,480966030,481018149,,1962,38,28,89,29,5,Spanish Hip-Hop,82,,1.001215541,1.00057266,1.00052447,303640,287542,291107,251670,274938,291962
Vigilante Shit,Taylor Swift,1,2022,415212763,415474703,415783042,416051098,416298838,416579341,416861413,418100264,,1948,0,12,9,16,0,Hip-Hop,0,,1.000677115,1.000673802,1.000595456,261940,308339,268056,247740,280503,282072
X SI VOLVEMOS,"Karol G, Romeo Santos",2,2023,528821983,529435715,530069415,530686587,531200875,531743448,532322094,531821445,,2127,33,45,80,53,8,Spanish Hip-Hop,4,,1.001088205,1.001021408,1.000969099,613732,633700,617172,514288,542573,578646
Cooped Up (with Roddy Ricch),"Post Malone, Roddy Ricch",2,2022,334110926,334218476,334334581,334435664,334525445,334627693,334824659,335984110,,2942,0,42,28,43,0,Hip-Hop,0,,1.000588612,1.000305651,1.000268455,107550,116105,101083,89781,102248,98483
Agar Tum Saath Ho,Arijit Singh,1,2019,434724917,435019399,435314174,435622962,435933562,436229719,436543476,436515309,,3618,0,21,86,138,0,Indian Hip-Hop,2,,1.000719247,1.000679363,1.000713002,294482,294775,308788,310600,296157,313757
Un Verano Sin Ti,Bad Bunny,1,2022,376903023,377172553,377408432,377651536,377871838,378111374,378605160,379518021,,1004,1,8,12,9,0,Spanish Hip-Hop,0,,1.001305927,1.000633908,1.000583347,269530,235879,243104,220302,239536,246893
Aguacero,Bad Bunny,1,2022,355856990,356076441,356269702,356469785,356649246,356846823,357244391,357884501,,829,0,4,15,10,0,Spanish Hip-Hop,0,,1.001114114,1.000553981,1.00050344,219451,193261,200083,179461,197577,198784
CAIRO,"Karol G, Ovy On The Drums",2,2022,468148256,468535273,468885920,469278568,469609056,469976574,470370235,471348073,,2418,26,52,66,55,1,Spanish Hip-Hop,16,,1.000837618,1.000782604,1.000704247,387017,350647,392648,330488,367518,393661
N95,Kendrick Lamar,1,2022,452990156,453382470,453757176,454109920,454418500,454779085,455522820,455335288,,5542,0,52,16,65,0,Rock,206,,1.001635376,1.000793509,1.000679527,392314,374706,352744,308580,360585,371187
WHERE SHE GOES,Bad Bunny,1,2023,746824675,747279109,747711862,748147024,748516396,748919800,749337556,750310447,,3133,50,84,133,87,15,Spanish Hip-Hop,425,,1.000557811,1.000538938,1.000493716,454434,432753,435162,369372,403404,417756
Gato de Noche,"Nengo Flow, Bad Bunny",2,2022,439665745,439848042,440025991,440203468,440351542,440509061,440838838,442487243,,2651,30,21,55,32,3,Spanish Hip-Hop,0,,1.000748627,1.000357712,1.000336376,182297,177949,177477,148074,157519,164889
Me Fui de Vacaciones,Bad Bunny,1,2022,379077553,379271624,379451948,379638798,379799985,379973012,380331872,380522693,,1443,0,9,11,22,1,Spanish Hip-Hop,0,,1.000944435,1.000455574,1.00042458,194071,180324,186850,161187,173027,179430
La Zona,Bad Bunny,1,2020,388330496,388456737,388602375,388734580,388844651,388962752,389212044,391443526,,1188,0,13,1,15,0,Spanish Hip-Hop,1,,1.000640915,1.000303723,1.000283152,126241,145638,132205,110071,118101,124646
Yo No Soy Celoso,Bad Bunny,1,2022,382438015,382624283,382826913,383019060,383180079,383349528,383696438,385548305,,1179,0,7,21,11,0,Spanish Hip-Hop,0,,1.000904944,1.000442218,1.000420394,186268,202630,192147,161019,169449,173455
Maroon,Taylor Swift,1,2022,473666906,473938572,474180070,474419112,474653842,474918404,475190613,476125909,,2304,0,12,16,14,0,Romantic,0,,1.00057317,1.000557379,1.000494773,271666,241498,239042,234730,264562,272209
Snow On The Beach (feat. Lana Del Rey),"Taylor Swift, Lana Del Rey",2,2022,441060877,441249746,441417777,441586658,441753303,441934699,442118725,444781315,,2415,0,33,57,30,0,Romantic,11,,1.00041641,1.000410627,1.000377378,188869,168031,168881,166645,181396,184026
Sacrifice,The Weeknd,1,2022,395220394,395358410,395476785,395597756,395710085,395839288,396107100,398164883,,4440,0,81,77,133,0,Hip-Hop,,,1.000676568,1.000326509,1.000283948,138016,118375,120971,112329,129203,133906
Bejeweled,Taylor Swift,1,2022,560948742,561310962,561751060,562123688,562466684,562860857,563257673,565047202,,2699,0,39,35,22,2,Hip-Hop,0,,1.000704998,1.000700794,1.000610179,362220,440098,372628,342996,394173,396816
Dos Mil 16,Bad Bunny,1,2022,444702163,444954672,445251659,445519415,445757568,446019328,446565811,447531196,,892,3,10,24,11,0,Spanish Hip-Hop,0,,1.001225245,1.000587225,1.000534551,252509,296987,267756,238153,261760,273241
Out of Time,The Weeknd,1,2022,467002463,467248937,467481058,467706922,467921019,468162544,468660266,468306158,,3711,0,49,88,62,0,Romantic,,,1.001063139,1.000516166,1.000457759,246474,232121,225864,214097,241525,248861
Andrea,"Buscabulla, Bad Bunny",2,2022,453634950,453928244,454279677,454594734,454875289,455179996,455805513,457054969,,1195,0,8,30,13,1,Spanish Hip-Hop,1,,1.001374219,1.000669869,1.000617154,293294,351433,315057,280555,304707,312758
"You're On Your Own, Kid",Taylor Swift,1,2022,614807689,615273216,615733690,616160650,616592273,617065780,617562041,616959784,,2537,2,8,18,20,0,Romantic,1,,1.000804227,1.000767942,1.000700504,465527,460474,426960,431623,473507,496261
"Kesariya (From ""Brahmastra"")","Pritam, Arijit Singh, Amitabh Bhattacharya",3,2022,537190715,537469880,537762533,538079288,538389823,538681387,538957800,540709507,,292,6,26,98,4,0,Indian Romantic,0,,1.000513129,1.000541548,1.000577118,279165,292653,316755,310535,291564,276413
Is There Someone Else?,The Weeknd,1,2022,707458385,708042167,708722011,709325107,709906235,710557466,711888292,711512744,,2881,6,13,89,34,0,Hip-Hop,3,,1.001872932,1.000917348,1.000819269,583782,679844,603096,581128,651231,665413
Un Coco,Bad Bunny,1,2022,566062952,566580020,567073418,567568714,568013357,568474907,569477856,568323335,,1029,28,5,28,9,0,Spanish Hip-Hop,0,,1.00176428,1.000812569,1.000783417,517068,493398,495296,444643,461550,501474
Karma,Taylor Swift,1,2022,814637695,815210321,815761896,816296924,816790470,817339533,817906602,821045577,,3818,23,37,55,32,0,Hip-Hop,272,,1.000693799,1.00067222,1.000604616,572626,551575,535028,493546,549063,567069
Un Ratito,Bad Bunny,1,2022,516858891,517082139,517335708,517566940,517771448,517994938,518471097,520898444,,1112,6,7,30,13,1,Spanish Hip-Hop,1,,1.000919235,1.000431638,1.000395133,223248,253569,231232,204508,223490,238079
Take My Breath,The Weeknd,1,2021,191401275,191512165,191623152,191728642,191826077,191937411,192167852,192266164,,6392,0,174,73,344,0,Romantic,0,,1.001200605,1.00058039,1.000508192,110890,110987,105490,97435,111334,115220
Midnight Rain,Taylor Swift,1,2022,681966356,682316239,682726510,683083477,683429138,683817020,684203312,686962915,,2612,4,19,29,21,0,Romantic,0,,1.000564906,1.000567553,1.00050603,349883,410271,356967,345661,387882,386292
La Corriente,"Tony Dize, Bad Bunny",2,2022,610849337,611116189,611415801,611696451,611939309,612197821,612739479,614560169,,1796,8,8,25,18,1,Spanish Hip-Hop,0,,1.000884776,1.000422447,1.000397024,266852,299612,280650,242858,258512,270829
Lavender Haze,Taylor Swift,1,2022,736559826,737077211,737534281,737727254,738084832,738483143,738891714,740839816,,3763,8,51,43,38,10,Romantic,1,,1.000553257,1.000539655,1.000484702,517385,457070,192973,357578,398311,408571
un x100to,"Bad Bunny, Grupo Frontera",2,2023,1061918779,1062721883,1063597359,1064481776,1065260538,1066031986,1067608511,1067343726,,2876,40,41,205,54,12,Spanish Hip-Hop,251,,1.001478872,1.000724187,1.000731588,803104,875476,884417,778762,771448,788262
Die For You - Remix,"Ariana Grande, The Weeknd",2,2023,955362105,956031877,956843819,957548895,958232598,958972328,960465841,961732737,,3408,47,87,86,74,1,Hip-Hop,16,,1.00155741,1.000771973,1.000714014,669772,811942,705076,683703,739730,746756
AM Remix,"J Balvin, Nio Garcia, Bad Bunny",3,2021,579586959,579737418,579863792,580000624,580113526,580236624,580501761,583162419,,6556,0,93,5,67,1,Spanish Hip-Hop,0,,1.000456946,1.000212196,1.000194658,150459,126374,136832,112902,123098,132568
La Jumpa,"Arcangel, Bad Bunny",2,2022,736404578,736697659,737003730,737233545,737549898,737827002,738419396,741229275,,3794,34,47,77,53,10,Spanish Hip-Hop,8,,1.00080289,1.000375709,1.000429108,293081,306071,229815,316353,277104,296197
One Right Now (with The Weeknd),"The Weeknd, Post Malone",2,2021,645557467,645797112,646011139,646218577,646405689,646617317,646840926,649215354,,4771,0,68,18,75,0,Hip-Hop,1,,1.000345814,1.000327392,1.000289549,239645,214027,207438,187112,211628,223609
family ties (with Kendrick Lamar),"Kendrick Lamar, Baby Keem",2,2021,831683293,832224805,832829685,833363221,833865912,834430590,835005374,836472946,,6308,5,114,15,63,0,Hip-Hop,2,,1.000688834,1.000677181,1.000603208,541512,604880,533536,502691,564678,574784
All Too Well (10 Minute Version) (Taylor's Version) (From The Vault),Taylor Swift,1,2021,878709198,879322411,879881572,880431425,880977014,881578908,882185073,885032664,,4635,5,50,49,30,1,Romantic,2,,1.00068759,1.000683212,1.000619684,613213,559161,549853,545589,601894,606165
august,Taylor Swift,1,2020,1182592418,1184404866,1186327503,1188052654,1189791548,1191708061,1193709644,1190380424,,7324,22,25,81,61,1,Romantic,44,,1.001679592,1.001610797,1.001463651,1812448,1922637,1725151,1738894,1916513,2001583
Tarot,"Bad Bunny, Jhay Cortez",2,2022,769956284,770347508,770808338,771233454,771597682,771993993,772821091,774267778,,2482,20,27,77,22,2,Spanish Hip-Hop,0,,1.001071379,1.000513624,1.000472267,391224,460830,425116,364228,396311,413549
I Like You (A Happier Song) (with Doja Cat),"Post Malone, Doja Cat",2,2022,854947166,855376107,855789214,856188582,856539606,856923746,857325322,861411330,,5281,14,94,21,80,15,Hip-Hop,38,,1.000468625,1.000448479,1.000409984,428941,413107,399368,351024,384140,401576
Volando - Remix,"Sech, Bad Bunny, Mora",3,2021,718370080,718640612,718938436,719226068,719476920,719755782,720345054,725411576,,3272,19,101,34,70,1,Spanish Hip-Hop,2,,1.000818711,1.00038759,1.00034878,270532,297824,287632,250852,278862,294636
Stargirl Interlude,"The Weeknd, Lana Del Rey",2,2016,1124772286,1125921270,1127031408,1128092145,1129127299,1130292807,1132558692,1134923572,,1275,32,13,8,5,0,Hip-Hop,1,,1.002004689,1.00103222,1.000917615,1148984,1110138,1060737,1035154,1165508,1132942.5
Moth To A Flame (with The Weeknd),"The Weeknd, Swedish House Mafia",2,2021,914671684,915465163,916283959,917038850,917726073,918511134,919303458,920621809,,7495,17,114,172,284,2,Hip-Hop,,,1.000862618,1.000855442,1.000749394,793479,818796,754891,687223,785061,792324
Party,"Bad Bunny, Rauw Alejandro",2,2022,743760997,744038492,744314018,744594543,744839229,745096324,745631276,746984145,,3185,4,38,64,37,3,Spanish Hip-Hop,36,,1.000717964,1.000345168,1.000328616,277495,275526,280525,244686,257095,267476
TQG,"Karol G, Shakira",2,2023,1085070654,1086023976,1086974853,1087939670,1088754476,1089633200,1090509232,1089589372,,4284,49,115,123,184,18,Spanish Hip-Hop,354,,1.00080397,1.000807091,1.000748944,953322,950877,964817,814806,878724,876032
Enchanted,Taylor Swift,1,2010,831665103,832031178,832355280,832689354,833033010,833376631,833724954,835883112,,4564,16,24,101,113,0,Romantic,40,,1.000417966,1.000412494,1.000412706,366075,324102,334074,343656,343621,348323
Neverita,Bad Bunny,1,2022,857661410,858076653,858486020,858904918,859252077,859604741,860344901,863015879,,2590,30,20,64,35,6,Spanish Hip-Hop,0,,1.000861047,1.000410431,1.000404188,415243,409367,418898,347159,352664,370080
You Right,"Doja Cat, The Weeknd",2,2021,858318295,858679886,859062821,859422094,859755346,860112656,860482697,863864671,,5073,0,83,9,100,0,Hip-Hop,4,,1.000430224,1.000415595,1.000387763,361591,382935,359273,333252,357310,370041
Volvi,"Aventura, Bad Bunny",2,2021,800016176,800391647,800715536,801066206,801352359,801666236,802343909,804229334,,5375,10,138,24,133,0,Spanish Hip-Hop,1,,1.000845331,1.000391684,1.000357215,375471,323889,350670,286153,313877,338836
Reminder,The Weeknd,1,2016,1055145125,1055746389,1056384813,1056980877,1057555866,1058172925,1059471639,1057807518,,6518,17,45,85,238,1,Hip-Hop,47,,1.001227317,1.000583477,1.000543992,601264,638424,596064,574989,617059,649357
A Tu Merced,Bad Bunny,1,2020,796322244,796583380,796856320,797121775,797351131,797602965,798146529,800399331,,4214,11,21,20,40,0,Spanish Hip-Hop,0,,1.000681497,1.000315838,1.00028773,261136,272940,265455,229356,251834,271782
Lost in the Fire,"The Weeknd, Gesaffelstein",2,2019,927970413,928417104,928883864,929323355,929752923,930222344,930685476,933472834,,7731,2,110,145,447,0,Hip-Hop,46,,1.000497872,1.000504888,1.000462237,446691,466760,439491,429568,469421,463132
After Hours,The Weeknd,1,2020,976783746,977391517,977927363,978480378,978984650,979540900,980115497,981477670,,8084,6,45,115,218,1,Romantic,221,,1.000586598,1.000568191,1.000515362,607771,535846,553015,504272,556250,574597
I Was Never There,"The Weeknd, Gesaffelstein",2,2018,1042273939,1043011634,1043726711,1044425017,1045116272,1045861884,1046619240,1049711700,,4188,15,30,70,142,0,Romantic,27,,1.000724145,1.000713425,1.000661852,737695,715077,698306,691255,745612,757356
MAMIII,"Karol G, Becky G",2,2022,958479877,959398373,960149994,961014551,961658732,962368418,963135716,963924377,,6809,28,151,102,175,5,Spanish Hip-Hop,29,,1.000797302,1.000737981,1.000670313,918496,751621,864557,644181,709686,767298
La Santa,"Daddy Yankee, Bad Bunny",2,2020,946856754,947328317,947868673,948379332,948831172,949356718,950463166,953286752,,4890,20,52,42,100,0,Spanish Hip-Hop,0,,1.001165471,1.000553888,1.000476434,471563,540356,510659,451840,525546,553224
Lo Siento BB:/ (with Bad Bunny & Julieta Venegas),"Julieta Venegas, Bad Bunny, Tainy",3,2021,938248476,938619014,939047893,939432379,939748136,940096534,942849010,943512337,,3423,26,61,65,53,6,Spanish Hip-Hop,0,,1.002927865,1.000370736,1.000336115,370538,428879,384486,315757,348398,2752476
Style,Taylor Swift,1,2014,1254168150,1254767934,1255409092,1256000486,1256567537,1257164684,1257781718,1262773794,,7830,42,94,111,151,4,Romantic,82,,1.000490814,1.000475221,1.000451474,599784,641158,591394,567051,597147,617034
Cruel Summer,Taylor Swift,1,2019,2379013696,2381710108,2384866291,2387693826,2390283564,2393100530,2399084517,2393105190,,7858,100,116,207,125,12,Romantic,548,,1.002500516,1.001178507,1.001084619,2696412,3156183,2827535,2589738,2816966,2991993.5
cardigan,Taylor Swift,1,2020,1376031261,1377241916,1378448011,1379572565,1380707037,1381958247,1383217032,1383281165,,7923,29,106,112,142,4,Romantic,215,,1.000910871,1.00090621,1.000822336,1210655,1206095,1124554,1134472,1251210,1258785
Creepin',"The Weeknd, 21 Savage, Metro Boomin",3,2022,1391835276,1392727651,1393573352,1394410573,1395175298,1396026585,1396890759,1398666064,,6036,88,113,149,245,23,Hip-Hop,27,,1.000619024,1.000610165,1.000548422,892375,845701,837221,764725,851287,864174
Lover,Taylor Swift,1,2012,1492157670,1493422745,1494884143,1496173151,1497417751,1498790244,1501552085,1501968001,,8448,23,160,110,163,0,Romantic,5,,1.001842713,1.000916573,1.000831856,1265075,1461398,1289008,1244600,1372493,1380920.5
PROVENZA,Karol G,1,2022,1246408815,1247327345,1248267141,1249229033,1250092425,1251165597,1252182878,1251878011,,6587,34,114,104,147,11, Spanish Hip-Hop,20,,1.000813067,1.000858474,1.00069114,918530,939796,961892,863392,1073172,1017281
Moscow Mule,Bad Bunny,1,2022,1152801710,1153535555,1154215413,1154931327,1155547057,1156183738,1157492869,1160683828,,4572,33,74,113,85,9,Spanish Hip-Hop,2,,1.001132286,1.000550978,1.000533131,733845,679858,715914,615730,636681,654565
Anti-Hero,Taylor Swift,1,2022,1627231291,1628137391,1629221868,1630164067,1631054245,1632045627,1633066995,1640047162,,9082,56,242,142,165,9,Hip-Hop,310,,1.000625821,1.000607817,1.000546067,906100,1084477,942199,890178,991382,1021368
Efecto,Bad Bunny,1,2022,1336701003,1337357130,1338037509,1338714823,1339325128,1339990412,1341282323,1343612814,,4004,33,34,65,43,6,Spanish Hip-Hop,2,,1.00096412,1.000496731,1.000455889,656127,680379,677314,610305,665284,645955
Money Trees,"Kendrick Lamar, Jay Rock",2,2012,1549057616,1550175730,1551404428,1552491732,1553469905,1554569296,1556842303,1558148673,,26792,32,69,113,695,0,Hip-Hop,458,,1.001462146,1.0007077,1.000630066,1118114,1228698,1087304,978173,1099391,1136503.5
Shake It Off,Taylor Swift,1,2014,1453661705,1454413167,1455076265,1455798506,1456439823,1457101014,1457779556,1460004048,,21335,13,328,70,"1,378",9,Hip-Hop,20,,1.000465679,1.000453978,1.000440526,751462,663098,722241,641317,661191,678542
Save Your Tears (with Ariana Grande) (Remix),"Ariana Grande, The Weeknd",2,2020,1604236119,1605318558,1606212091,1607173615,1608019295,1608958428,1610804475,1613627663,,9161,5,240,98,468,3,Romantic,10,,1.001147355,1.000584031,1.000526191,1082439,893533,961524,845680,939133,923023
Yonaguni,Bad Bunny,1,2021,1421392549,1421726537,1422113012,1422475010,1422796658,1423133517,1423842333,1428509710,,9644,28,120,86,164,4,Spanish Hip-Hop,0,,1.000498067,1.000236758,1.000226119,333988,386475,361998,321648,336859,354408
Titi Me Pregunto,Bad Bunny,1,2022,1557268957,1558137964,1559141664,1559811060,1560396409,1560989769,1562201639,1571878421,,9037,42,124,133,139,14,Spanish Hip-Hop,166,,1.000776347,1.000380262,1.000375269,869007,1003700,669396,585349,593360,605935
Callaita,"Bad Bunny, Tainy",2,2019,1482670749,1483204956,1483721396,1484247450,1484701117,1485175260,1486167179,1490266880,,9539,15,162,116,355,7,Spanish Hip-Hop,0,,1.068000001,1.000319352,1.000305655,534207,516440,526054,453667,474143,495959
Blank Space,Taylor Swift,1,2014,1878742582,1879635267,1880374940,1881158257,1881898271,1882674793,1883485391,1893945238,,11434,53,154,123,410,2,Romantic,81,,1.000430557,1.000412627,1.000393382,892685,739673,783317,740014,776522,810598
LA CANCION,"J Balvin, Bad Bunny",2,2019,1770863288,1771920884,1773094420,1774184160,1775116946,1776142388,1778381002,1782340932,,6398,31,177,109,305,3,Spanish Hip-Hop,5,,1.00126038,1.000577676,1.000525755,1057596,1173536,1089740,932786,1025442,1119307
Me Porto Bonito,"Chencho Corleone, Bad Bunny",2,2022,1871603304,1872553503,1873385522,1874299765,1875120505,1876017527,1877856442,1883765709,,8870,43,104,120,141,26,Spanish Hip-Hop,49,,1.000980223,1.000478381,1.000437892,950199,832019,914243,820740,897022,919447
Call Out My Name,The Weeknd,1,2018,1841551833,1842594784,1843537792,1844486531,1845386201,1846421397,1847487615,1850599337,,11087,6,151,107,801,1,Romantic,105,,1.000577451,1.000560964,1.000487762,1042951,943008,948739,899670,1035196,1066218
Save Your Tears,The Weeknd,1,2020,2062016507,2063279250,2064369863,2065506931,2066497908,2067594065,2068711330,2075490542,,12688,13,197,115,112,0,Romantic,200,,1.00054037,1.000530442,1.000479774,1262743,1090613,1137068,990977,1096157,1117265
Die For You,The Weeknd,1,2016,2361077414,2362607702,2364216248,2365729334,2367148484,2368657360,2370247628,2375031223,,2483,59,68,21,24,0,Romantic,259,,1.00067138,1.000637423,1.000599878,1530288,1608546,1513086,1419150,1508876,1590268
Dakiti,"Bad Bunny, Jhay Cortez",2,2020,2023464381,2024178674,2024859925,2025564842,2026188671,2026857088,2028187964,2038327305,,11215,21,189,166,525,9,Spanish Hip-Hop,25,,1.000656621,1.000329889,1.000307978,714293,681251,704917,623829,668417,665438
HUMBLE.,Kendrick Lamar,1,2017,2298616678,2299739051,2300799410,2301829411,2302756889,2303833700,2304907635,2316662139,,33206,1,284,114,"1,481",0,Hip-Hop,5,,1.000466151,1.000467618,1.000402931,1122373,1060359,1030001,927478,1076811,1073935
The Hills,The Weeknd,1,2015,2369991770,2370971185,2372061087,2373054085,2374018901,2375081942,2376175238,2379603896,,25744,4,122,94,"1,992",0,Hip-Hop,18,,1.000460319,1.000447781,1.000406571,979415,1089902,992998,964816,1063041,1093296
Circles,Post Malone,1,2019,2548327819,2549451108,2550686613,2551812449,2552788034,2553873500,2555007033,2569243775,,19664,16,391,73,633,3,Hip-Hop,37,,1.000443849,1.000425208,1.000382311,1123289,1235505,1125836,975585,1085466,1133533
Starboy,"The Weeknd, Daft Punk",2,2016,3407044941,3408928585,3410730685,3412529684,3414237206,3416070599,3417924220,3432851320,,29536,79,281,137,"2,445",1,Hip-Hop,140,,1.000542618,1.000536985,1.000500368,1883644,1802100,1798999,1707522,1833393,1853621
Sunflower - Spider-Man: Into the Spider-Verse,"Post Malone, Swae Lee",2,2018,3458429394,3460002981,3461728993,3463327362,3464773397,3466282113,3469547836,3479972212,,24094,78,372,117,843,4,Hip-Hop,69,,1.00094214,1.000435444,1.000417528,1573587,1726012,1598369,1446035,1508716,1622852
Blinding Lights,The Weeknd,1,2019,4393110112,4395164567,4396852786,4398701463,4400288620,4401999109,4403744736,4407836616,,43899,69,672,199,"3,421",20,Hip-Hop,,,1.000396553,1.000388722,1.000360824,2054455,1688219,1848677,1587157,1710489,1745627
